1111111111111
1P00000000001
100C000000001
1000000000C01
1000000000001
1000E0000C001
1111111111111