
11111111
1CC00P11
1E000011
1EC11111
11111111